RRRRRRRRR
R.E.....R
R....L..R
R..GGG..R
R..GGG..R
R..GGG..R
R.....@.R
R.E.....R
RRRRRRRRR