###########################################
#                                         #
#     ############  ###############       #
#         #                 #             #
#         ##                            ###
#  ######    ################  ########   #
#  ############      #        #        #  #
#  #   #   #  #      #        #           #
#    #   #       1   #        # # #### #  #
###############      #        # #         #
#                             #           #
#   #############   #############    ###  #
#                                         #
###########################################
