###########################################
#                                         #
# ####################################### #
# #      #        #  #    #  #      #   # #
# # ###  #   #    #       #     #       # #
#   #    #   #       #    #  ######## ### #
######   ### # #######        #         # #
#    #       #       #  #######  ######## #
# #  ############### ####                 #
# #     #     #         #   ###############
# #  #     #    #       #   #             #
# ################ ####### ##   ####### ###
#                   #       #   #         #
###### ################ #####   ##  #######
#                               #      1  #
###########################################
